 freq - frequency{Space}
 freqn - frequent{Space}
 requi - require{Space}
 que - queue{Space}
 acqr - acquire{Space}
 rqst - request{Space}
 quiet - quiet{Space}
 uniqe - unique{Space}
 eql - equal{Space}
 quer - queer{Space}
 ql - quickly{Space}
 quote - quote{Space}
 qlf - qualify{Space}
 squirt - squirt{Space}
 qlfy - qualify{Space}
 equip - equip{Space}
 consequ - consequence{Space}
 esqu - {BackSpace}-esque{Space}
 rq - require{Space}
 sqrl - squirrel{Space}
 query - query{Space}
 seq - sequence{Space}
 equity - equity{Space}
 frq - frequent{Space}
 frqnt - frequent{Space}
 sqnc - sequence{Space}
 quantm - quantum{Space}
 qt - question{Space}
 qit - quite{Space}
 qlt - quality{Space}
 qst - questions{Space}
 quit - quit{Space}
 unq - unique{Space}
 qrt - quarter{Space}
 aw - as well{Space}
 hwvr - however{Space}
 wnt - won't{Space}
 whenvr - whenever{Space}
 awesom - awesome{Space}
 wrap - wrap{Space}
 blw - below{Space}
 below - below{Space}
 wan - want to{Space}
 chew - chew{Space}
 wife - wife{Space}
 swivel - swivel{Space}
 wheras - whereas{Space}
 whenvr - whenever{Space}
 winer - winner{Space}
 empowr - empower{Space}
 shower - shower{Space}
 wither - wither{Space}
 skew - skew{Space}
 whistle - whistle{Space}
 hmwk - homework{Space}
 swim - swim{Space}
 swalo - swallow{Space}
 blow - blow{Space}
 war - war{Space}
 brw - borrow{Space}
 wrsm - worrisome{Space}
 pwrf - powerful{Space}
 wdv - would've{Space}
 nowher - nowhere{Space}
 howevr - however{Space}
 wrth - worth{Space}
 worse - worse{Space}
 wed - we'd{Space}
 wine - wine{Space}
 weath - weather{Space}
 wealth - wealth{Space}
 flow - flow{Space}
 power - power{Space}
 wernt - weren't{Space}
 wrtn - written{Space}
 wand - wand{Space}
 wld - wield{Space}
 wave - wave{Space}
 blew - blew{Space}
 blew - blew{Space}
 women - women{Space}
 wrote - wrote{Space}
 wrote - wrote{Space}
 wlcm - welcome{Space}
 wmn - women{Space}
 wmn - woman{Space}
 slow - slow{Space}
 hrdw - hardware{Space}
 worst - worst{Space}
 wory - worry{Space}
 gnaw - gnaw{Space}
 lawn - lawn{Space}
 awn - awn{Space}
 walks - walks{Space}
 dwnl - download{Space}
 whale - whale{Space}
 whel - wheel{Space}
 wife - wife{Space}
 weigh - weigh{Space}
 wise - wise{Space}
 whose - whose{Space}
 swoeh - swore{Space}
 weathr - weather{Space}
 weight - weight{Space}
 west - west{Space}
 wild - wild{Space}
 win - win{Space}
 cow - cow{Space}
 mow - mow{Space}
 wrngl - wrangle{Space}
 nwhr - nowhere{Space}
 lwnmr - lawnmower{Space}
 wrs - worse{Space}
 worst - worst{Space}
 wsdm - wisdom{Space}
 walk - walk{Space}
 alw - always{Space}
 was - was{Space}
 was - was{Space}
 wash - wash{Space}
 fwd - forward{Space}
 wdn - wouldn't{Space}
 we - we{Space}
 weak - weak{Space}
 awesm - awesome{Space}
 few - few{Space}
 whe - when{Space}
 when - when{Space}
 wide - wide{Space}
 wide - wide{Space}
 while - while{Space}
 wise - wise{Space}
 wished - wished{Space}
 view - view{Space}
 wek - week{Space}
 knew - knew{Space}
 wel - well{Space}
 new - new{Space}
 whole - whole{Space}
 wer - were{Space}
 wear - wear{Space}
 answer - answer{Space}
 crew - crew{Space}
 wher - where{Space}
 weird - weird{Space}
 reviw - review{Space}
 browse - browse{Space}
 water - water{Space}
 whetr - whether{Space}
 witer - Twitter{Space}
 wanted - wanted{Space}
 betwn - between{Space}
 white - white{Space}
 went - went{Space}
 evw - everywhere{Space}
 flw - follow{Space}
 wkg - working{Space}
 wlkg - walking{Space}
 wh - who{Space}
 when - when{Space}
 whl - whole{Space}
 whn - when{Space}
 wind - wind{Space}
 whic - which{Space}
 wil - will{Space}
 windo - window{Space}
 wish - wish{Space}
 wk - work{Space}
 wlk - walk{Space}
 wl - we'll{Space}
 nw - network{Space}
 wo - would{Space}
 alow - allow{Space}
 wod - wood{Space}
 down - down{Space}
 how - how{Space}
 know - know{Space}
 low - low{Space}
 now - now{Space}
 show - show{Space}
 snow - snow{Space}
 nwp - newspaper{Space}
 wr - we're{Space}
 wr - we're{Space}
 draw - draw{Space}
 warm - warm{Space}
 wdrf - wonderful{Space}
 wndrf - wonderful{Space}
 wndr - wonder{Space}
 wrk - work{Space}
 word - word{Space}
 world - world{Space}
 grow - grow{Space}
 wrong - wrong{Space}
 work - work{Space}
 wrt - write{Space}
 wrtg - writing{Space}
 tmrw - tomorrow{Space}
 throw - throw{Space}
 wtvr - whatever{Space}
 rvw - review{Space}
 ws - website{Space}
 sfw - software{Space}
 smw - somewhere{Space}
 wt - what{Space}
 wantd - wanted{Space}
 wantd - wanted{Space}
 what - what{Space}
 watch - watch{Space}
 want - want{Space}
 wasnt - wasn't{Space}
 wsn - wasn't{Space}
 btw - by the way{Space}
 twd - toward{Space}
 wht - whether{Space}
 wtch - watch{Space}
 wit - within{Space}
 wait - wait{Space}
 switch - switch{Space}
 wto - without{Space}
 town - town{Space}
 wtou - without{Space}
 wtv - whatever{Space}
 ntvw - interview{Space}
 wv - we've{Space}
 wv - we've{Space}
 way - way{Space}
 anywh - anywhere{Space}
 anyw - anyway{Space}
 why - why{Space}
 ylw - yellow{Space}
 grew - grew{Space}
 twice - twice{Space}
 whats - what's{Space}
 wts - what's{Space}
 ar - around{Space}
 saviour - saviour{Space}
 thrpy - therapy{Space}
 dtrmnl - detrimental{Space}
 trdnl - traditional{Space}
 cry - cry{Space}
 prsdnt - president{Space}
 guitar - guitar
 trip - trip{Space}
 hours - hours{Space}
 drink - drink{Space}
 frica - Africa{Space}
 arcti - arctic{Space}
 ntarci - Antarctica{Space}
 brw - borrow{Space}
 hrbl - horrible{Space}
 pr - peer{Space}
 march - march{Space}
 drv - drive{Space}
 brdn - burden{Space}
 grdn - garden{Space}
 cnfr - conference{Space}
 nfrm - inform{Space}
 cigar - cigar{Space}
 rid - rid{Space}
 bird - bird{Space}
 inform - inform{Space}
 miro - mirror{Space}
 minor - minor{Space}
 prila - April{Space}
 cris - crisis{Space}
 insrc - insurance{Space}
 cmrl - commercial{Space}
 major - major{Space}
 donr - donor{Space}
 colr - color{Space}
 groom - groom{Space}
 prnc - pronounce{Space}
 prscb - prescribe{Space}
 cmprs - compromise{Space}
 src - source{Space}
 jrnls - journalist{Space}
 scrath - scratch{Space}
 avtr - avatar{Space}
 grtfl - grateful{Space}
 gnrt - generate{Space}
 intrfc - interface{Space}
 inovatr - innovator{Space}
 constri - constrict{Space}
 shirt - shirt{Space}
 doctr - doctor{Space}
 forth - forth{Space}
 prmnt - prominent{Space}
 trnscp - transcript{Space}
 prstn - proposition{Space}
 mstrd - mustard{Space}
 hstrcl - historical{Space}
 jrnlst - journalist{Space}
 mnitru - monitor{Space}
 truck - truck{Space}
 constru - construct{Space}
 abrupt - abrupt{Space}
 struck - struck{Space}
 invtry - inventory{Space}
 trophy - trophy{Space}
 hystrcl - hysterical{Space}
 sugar - sugar{Space}
 rough - rough{Space}
 dlvry - delivery{Space}
 bryf - February{Space}
 nryj - January{Space}
 dscvry - discovery{Space}
 srgy - surgery{Space}
 sumary - summary{Space}
 urs - yours{Space}
 crital - critical{Space}
 prosal - proposal{Space}
 rsch - proposal{Space}
 src - source{Space}
 angry - angry{Space}
 ignr - ignore{Space}
 cngrtls - congratulations{Space}
 frv - forever{Space}
 cmptr - competitor{Space}
 rl - real{Space}
 intrl - internal{Space}
 naturl - natural{Space}
 brth - breath{Space}
 cntrl - control{Space}
 hrd - heard{Space}
 mlcr - molecular{Space}
 rdy - ready{Space}
 broach - broach{Space}
 vari - vari{Space}
 sprd - spread{Space}
 prchs - purchase{Space}
 algrthm - algorithm{Space}
 chord - chord{Space}
 argmnt - argument{Space}
 frth - further{Space}
 distrc - district{Space}
 xpndtr - expenditure{Space}
 farm - farm{Space}
 arg - argue{Space}
 crak - crack{Space}
 arm - arm{Space}
 rlvnt - relevant{Space}
 arm - arm{Space}
 dfrnc - difference{Space}
 fdrl - federal{Space}
 brf - brief{Space}
 cnfrm - confirm{Space}
 fngr - finger{Space}
 chrg - charge{Space}
 gnrl - general{Space}
 lvrg - leverage{Space}
 chrnl - chronicle{Space}
 air - air{Space}
 brain - brain{Space}
 crib - crib{Space}
 rid - rid{Space}
 rif - riff{Space}
 graphic - graphic{Space}
 princal - principal{Space}
 imprvs - improvise{Space}
 risk - risk{Space}
 jnr - junior{Space}
 mkr - maker{Space}
 clr - clear{Space}
 crlm - curriculum{Space}
 mrcl - miracle{Space}
 absor - absorb{Space}
 obsrv - observe{Space}
 graph - graph{Space}
 graphc - graphic{Space}
 grp - grp group{Space}
 prncl - principle{Space}
 cmprsn - comparison{Space}
 sphmr - sophomore{Space}
 plsr - pleasure{Space}
 prsnl - personal{Space}
 srfc - surface{Space}
 frshmn - freshman{Space}
 slfrc - salesforce{Space}
 snglr - singular{Space}
 snglr - singular{Space}
 cnslr - counselor{Space}
 xrcs - exercise{Space}
 grant - grant{Space}
 smart - smart{Space}
 fctr - factor{Space}
 frgtn - forgotten{Space}
 nthr - neither{Space}
 third - third{Space}
 historc - historic{Space}
 string - string{Space}
 mrkt - market{Space}
 factor - factor{Space}
 forgt - forgot{Space}
 north - north{Space}
 parot - parrot{Space}
 trapo - transport{Space}
 prtcl - particular{Space}
 spctlr - spectacular{Space}
 trspcl - transport{Space}
 trnsp. - transportation{Space}
 prmtv - primitive{Space}
 prvnt - prevent{Space}
 xprmnt - experiment{Space}
 cntrs - countries{Space}
 dstrb - disturb{Space}
 trnsf - transfer{Space}
 hstrc - historic{Space}
 traum - trauma{Space}
 tour - tour{Space}
 author - author{Space}
 atrny - attorney{Space}
 prty - property{Space}
 prty - property{Space}
 guard - guard{Space}
 burn - burn{Space}
 round - round{Space}
 ours - ours{Space}
 rush - rush{Space}
 anymr - anymore{Space}
 anymr - anymore{Space}
 jrny - journey{Space}
 spray - spray{Space}
 chptr - chapter{Space}
 dstrc - district{Space}
 ctgry - category{Space}
 card - card{Space}
 for - for{Space}
 yard - yard{Space}
 grad - grad{Space}
 hard - hard{Space}
 mark - mark{Space}
 advsr - advisor{Space}
 rcmnd - recommend{Space}
 gndr - gender{Space}
 hndr - hundred{Space}
 dlvr - deliver{Space}
 drm - dream{Space}
 rnd - round{Space}
 rndm - random{Space}
 vndr - vendor{Space}
 frc - force{Space}
 frc - force{Space}
 rfnc - reference{Space}
 cnfr - conference{Space}
 flvr - flavor{Space}
 frm - firm{Space}
 rg - regard{Space}
 ncrg - encourage{Space}
 rgl - regular{Space}
 lvrg - leverage{Space}
 chmbr - chamber{Space}
 bhvr - behavior{Space}
 drain - drain{Space}
 hair - hair{Space}
 firm - firm{Space}
 incrs - increase{Space}
 rlb - reliable{Space}
 cmrl - commercial{Space}
 lvr - lever{Space}
 labor - labor{Space}
 dor - door{Space}
 orgnc - organic{Space}
 honr - honor{Space}
 rock - rock{Space}
 colr - color{Space}
 drp - drop{Space}
 aprv - approve{Space}
 prcv - perceive{Space}
 prdn - pardon{Space}
 grphc - graphic{Space}
 plr - popular{Space}
 prcs - precise{Space}
 prsnc - presence{Space}
 prfs - profess{Space}
 prgs - progress{Space}
 ncrs - increase{Space}
 cnsmr - consumer{Space}
 dsr - desire{Space}
 dcrs - decrease{Space}
 rdcls - ridiculous{Space}
 srnd - surround{Space}
 dsrv - deserve{Space}
 vrs - various{Space}
 xrcs - exercise{Space}
 xrcs - exercise{Space}
 atrb - attribute{Space}
 artcl - article{Space}
 cntrb - contribute{Space}
 crdnt - coordinate{Space}
 crdint - coordinate{Space}
 mnfctr - manufacture{Space}
 rflct - reflect{Space}
 trial - trial{Space}
 trick - trick{Space}
 clbrt - collaborate{Space}
 rot - root{Space}
 orchsta - orchestra{Space}
 promt - prompt{Space}
 prft - profit{Space}
 nprft - nonprofit{Space}
 trnspcy - transparency{Space}
 dscrptn - description{Space}
 nsprt - inspiration{Space}
 prvnti - prevent{Space}
 prvnt - prevent{Space}
 xprt - expert{Space}
 cntrs - contrast{Space}
 dmnstr - demonstrate{Space}
 strgl - struggle{Space}
 rstn - restaurant{Space}
 rsnt - resonate{Space}
 rstn - restaurant{Space}
 nstrm - instrument{Space}
 tumor - tumor{Space}
 cntry - country{Space}
 chmtry - chemistry{Space}
 rhytm - rhythm{Space}
 scrty - security{Space}
 hstry - history{Space}
 drug - drug{Space}
 brv - brave{Space}
 rmv - remove{Space}
 nrlgy - neurology{Space}
 imprv - improve{Space}
 drum - drum{Space}
 grab - grab{Space}
 rcv - receive{Space}
 brdn - burden{Space}
 prio - prior{Space}
 rmn - remain{Space}
 cmpr - compare{Space}
 prms - promise{Space}
 prms - promise{Space}
 srvc - service{Space}
 dscvr - discover{Space}
 srnd - surround{Space}
 srv - survive{Space}
 vrsn - version{Space}
 trd - tried{Space}
 dghtr - daughter{Space}
 frgt - forget{Space}
 tchr - teacher{Space}
 train - train{Space}
 crit - critic{Space}
 constri - construction{Space}
 critsm - criticism{Space}
 mtrl - material{Space}
 rltn - relation{Space}
 cnstr - construct{Space}
 cnstrv - constructive{Space}
 rsltn - resolution{Space}
 cary - carry{Space}
 rth - rather{Space}
 bar - bar{Space}
 acr - across{Space}
 brand - brand{Space}
 hard - hard{Space}
 far - far{Space}
 frank - frank{Space}
 ral - ral
 xra - extra{Space}
 br - br
 rmb - remember{Space}
 brn - brain{Space}
 cr - crazy{Space}
 rd - read{Space}
 drg - during{Space}
 rlzd - realized{Space}
 fr - from{Space}
 fgr - figure{Space}
 fmlr - familiar{Space}
 rfn - refine{Space}
 brg - bring{Space}
 mngr - manager{Space}
 mornig - morning{Space}
 rcgnz - recognize{Space}
 hr - here{Space}
 fair - fair{Space}
 childr - children{Space}
 chldrn - children{Space}
 bring - bring{Space}
 girl - girl{Space}
 rich - rich{Space}
 micro - micro
 pair - pair{Space}
 mjr - major{Space}
 nrml - normal{Space}
 rlz - realize{Space}
 mr - more{Space}
 rn - right now{Space}
 or - or{Space}
 macro - macro
 road - road{Space}
 board - board{Space}
 onbard - onboard{Space}
 dolar - dollar{Space}
 normal - normal{Space}
 form - form{Space}
 org - organization{Space}
 orgnl - original{Space}
 orgn - original{Space}
 morng - morning{Space}
 rol - roll{Space}
 norml - normal{Space}
 rom - room{Space}
 pro - pro
 prob - probably{Space}
 drop - drop{Space}
 prdct - product{Space}
 proj - project{Space}
 probl - problem{Space}
 cros - cross{Space}
 orgs - organizations{Space}
 scrol - scroll{Space}
 apr - appreciate{Space}
 aprch - approach{Space}
 park - park{Space}
 prb - problem{Space}
 prc - process{Space}
 prcd - proceed{Space}
 prvd - provide{Space}
 prf - professional{Space}
 prfmnc - performance{Space}
 prfl - profile{Space}
 prfm - perform{Space}
 prgm - program{Space}
 prbl - problem{Space}
 xplr - explore{Space}
 srp - surprise{Space}
 rspnbl - responsible{Space}
 rspnd - respond{Space}
 prhs - perhaps{Space}
 rspnbt - responsibility{Space}
 rspn - response{Space}
 sr - sure{Space}
 dscrb - describe{Space}
 cnsdr - consider{Space}
 rls - release{Space}
 smlr - similar{Space}
 svrl - several{Space}
 rsn - reason{Space}
 rt - right{Space}
 trad - traditional{Space}
 track - track{Space}
 alrt - alright{Space}
 artcl - article{Space}
 antr - another{Space}
 stra - strategy{Space}
 standr - standard{Space}
 trans - trans{Space}
 crt - create{Space}
 crtn - certain{Space}
 crtv - creative{Space}
 rflct - reflect{Space}
 frtn - fortunate{Space}
 trg - trying{Space}
 crtg - creating{Space}
 tghr - together{Space}
 tri - tri
 trafic - traffic{Space}
 intra - intra
 strain - strain{Space}
 transio - transition{Space}
 intgr - integrate{Space}
 litr - literally{Space}
 cordint - coordinate{Space}
 introd - introduce{Space}
 intro - intro{Space}
 parti - particular{Space}
 ltr - literal{Space}
 trbl - trouble{Space}
 ctrl - control{Space}
 clbrt - collaborate{Space}
 rltv - relative{Space}
 rmt - remote{Space}
 ntr - entire{Space}
 actor - actor{Space}
 contra - contract{Space}
 obtr - obtrusive{Space}
 contr - contro
 front - front{Space}
 tomr - tomorrow{Space}
 sort - sort{Space}
 storg - storage{Space}
 strong - strong{Space}
 short - short{Space}
 rpt - repeat{Space}
 part - part{Space}
 pract - practice{Space}
 aprnt - apparent{Space}
 pctr - picture{Space}
 prctn - perception{Space}
 sprt - separate{Space}
 rspct - respect{Space}
 prsctv - perspective{Space}
 prvt - private{Space}
 str - start{Space}
 stbrn - stubborn{Space}
 cstmr - customer{Space}
 dstr - disastrous{Space}
 dstrc - distract{Space}
 stndr - standard{Space}
 strg - starting{Space}
 strgh - straight{Space}
 strm - stream{Space}
 brutal - brutal{Space}
 cultra - cultural{Space}
 hurt - hurt{Space}
 throug - through{Space}
 turn - turn{Space}
 suport - support{Space}
 trus - trust{Space}
 nrtv - narrative{Space}
 try - try{Space}
 story - story{Space}
 party - party{Space}
 truly - truly{Space}
 ur - your{Space}
 various - various{Space}
 curios - curious{Space}
 run - run{Space}
 our - our{Space}
 ocur - occur{Space}
 ground - ground{Space}
 hour - hour{Space}
 group - group{Space}
 purch - purchase{Space}
 vr - virtual reality{Space}
 yr - year{Space}
 ary - {BackSpace}ary{Space}
 frankly - frankly{Space}
 vary - vary{Space}
 sory - sorry{Space}
 prvcy - privacy{Space}
 yrs - years{Space}
 ran - ran{Space}
 rcvd - received{Space}
 jrnl - journal{Space}
 apro - approach{Space}
 aproch - approach{Space}
 ramp - ramp{Space}
 prvs - previous{Space}
 msr - measure{Space}
 art - art{Space}
 atrc - attract{Space}
 drct - direct{Space}
 grdt - graduate{Space}
 dtrmn - determine{Space}
 ftr - feature{Space}
 brght - brought{Space}
 train - train{Space}
 artis - artist{Space}
 print - print{Space}
 prtl - partial{Space}
 prmt - promote{Space}
 dstrb - distribute{Space}
 proud - proud{Space}
 ptrn - pattern{Space}
 prmy - primary{Space}
 at - at{Space}
 thad - that'd{Space}
 vist - visit{Space}
 thin - thin{Space}
 plsnt - pleasant{Space}
 advct - advocate{Space}
 math - math{Space}
 putg - putting{Space}
 tank - tank{Space}
 vgtl - vegetable{Space}
 nvgt - navigate{Space}
 faith - faith{Space}
 split - split{Space}
 tail - tail{Space}
 asit - assist{Space}
 flight - flight{Space}
 might - might{Space}
 inclt - inoculate{Space}
 conflit - conflict{Space}
 paint - paint{Space}
 paint - paint{Space}
 vist - visit{Space}
 botch - botch{Space}
 cloth - cloth{Space}
 stopg - stopping{Space}
 stod - stood{Space}
 smoth - smooth{Space}
 smoth - smooth{Space}
 lost - lost{Space}
 asmptn - assumption{Space}
 ptnc - patience{Space}
 cmptv - competitive{Space}
 ktchp - ketchup{Space}
 tlscp - telescope{Space}
 dsmnt - disseminate{Space}
 sfct - suffocate{Space}
 blsht - bullshit{Space}
 adult - adult{Space}
 fault - fault{Space}
 ugsta - August{Space}
 hunt - hunt{Space}
 unit - unit{Space}
 caution - caution{Space}
 stupid - stupid{Space}
 sucint - succinct{Space}
 utlz - utilize{Space}
 acustom - accustom{Space}
 outcm - outcome{Space}
 consult - consult{Space}
 putg - putting{Space}
 stuck - stuck{Space}
 fclty - facility{Space}
 bought - bought{Space}
 xpct - expect{Space}
 ptnc - patience{Space}
 ptn - patient{Space}
 cmptv - competitive{Space}
 caught - caught{Space}
 cmpnst - compensate{Space}
 lft - left{Space}
 adult - adult{Space}
 sntv - sensitive{Space}
 gvmt - government{Space}
 dont - don't{Space}
 atmc - automatic{Space}
 tx - text{Space}
 cath - catch{Space}
 match - match{Space}
 sat - sat{Space}
 adtnl - additional{Space}
 adtn - addition{Space}
 vldt - validate{Space}
 indct - indicate{Space}
 capitl - capital{Space}
 instd - instead{Space}
 xpct - expect{Space}
 lost - lost{Space}
 mplnt - implement{Space}
 cnstl - constantly{Space}
 dstnc - distance{Space}
 sgnfct - significant{Space}
 input - input{Space}
 dntfy - identify{Space}
 study - study{Space}
 cast - cast{Space}
 hadnt - hadnt{Space}
 thal - thatll{Space}
 agnst - against{Space}
 thanks - thanks{Space}
 btn - button{Space}
 atic - attic{Space}
 insta - instant{Space}
 digt - digit{Space}
 fit - fit{Space}
 gift - gift{Space}
 fight - fight{Space}
 thick - thick{Space}
 limt - limit{Space}
 contai - contain{Space}
 tonigh - tonight{Space}
 motin - motion{Space}
 mist - mist{Space}
 tnk - think{Space}
 tao - tattoo{Space}
 coast - coast{Space}
 fot - foot{Space}
 thong - thong{Space}
 stop - stop{Space}
 ndpt - independent{Space}
 plt - pollute{Space}
 mplctn - implication{Space}
 mplnt - implement{Space}
 mplctns - implications{Space}
 smpt - symptom{Space}
 trade - trade{Space}
 sbmt - submit{Space}
 sbtnc - substance{Space}
 mnfst - manifest{Space}
 sgtn - suggestion{Space}
 tks - takes{Space}
 xtns - extension{Space}
 auth - authorize{Space}
 authnc - authentic{Space}
 mountai - mountain{Space}
 insult - insult{Space}
 cult - cult{Space}
 outsd - outside{Space}
 south - south{Space}
 shout - shout{Space}
 ntv - initiative{Space}
 mtvn - motivation{Space}
 sympt - symptom{Space}
 county - county{Space}
 cndt - condition{Space}
 cndt - candidate{Space}
 dcmnt - document{Space}
 xtnd - extend{Space}
 ngt - negotiate{Space}
 dict - dict{Space}
 idntf - identify{Space}
 imdt - immediate{Space}
 lift - lift{Space}
 comit - commit{Space}
 topic - topic{Space}
 tip - tip{Space}
 tips - tips{Space}
 shift - shift{Space}
 slight - slight{Space}
 isnt - isn't{Space}
 clmt - climate{Space}
 ntl - national{Space}
 octv - octave{Space}
 objctv - objective{Space}
 apnt - appoint{Space}
 apntm - appointment{Space}
 cmpt - compete{Space}
 pltc - politic{Space}
 cmplnt - complement{Space}
 snpcht - snapchat{Space}
 pstn - position{Space}
 cnst - constant{Space}
 cnst - consistent{Space}
 cnst - constant{Space}
 scnt - scientist{Space}
 dstnc - distance{Space}
 thsnd - thousand{Space}
 duct - duct{Space}
 studio - studio{Space}
 suit - suit{Space}
 doubt - doubt{Space}
 condut - conduct{Space}
 outlk - outlook{Space}
 shut - shut{Space}
 mtv - motive{Space}
 nvt - invite{Space}
 bty - beauty{Space}
 cnty - county{Space}
 tiny - tiny{Space}
 capty - capacity{Space}
 act - act{Space}
 btfl - beautiful{Space}
 hasnt - hasn't{Space}
 btfl - beautiful{Space}
 ngtv - negative{Space}
 maint - maintain{Space}
 itl - it'll{Space}
 impact - impact{Space}
 shot - shot{Space}
 cstm - costume{Space}
 fntsc - fantastic{Space}
 situao - situation{Space}
 situao - situation{Space}
 cant - can't{Space}
 dat - data{Space}
 fact - fact{Space}
 talkg - talking{Space}
 agnt - against{Space}
 tha - that{Space}
 chat - chat{Space}
 thank - thank{Space}
 than - than{Space}
 talk - talk{Space}
 actl - actually{Space}
 amt - amount{Space}
 atn - attention{Space}
 stand - stand{Space}
 fast - fast{Space}
 thas - that's{Space}
 stack - stack{Space}
 last - last{Space}
 btm - bottom{Space}
 ct - content{Space}
 cmt - community{Space}
 cnt - continue{Space}
 td - today{Space}
 dcmnt - document{Space}
 cnfdt - confident{Space}
 dgtl - digital{Space}
 dtl - detail{Space}
 dnt - don't{Space}
 xtd - excited{Space}
 ft - first{Space}
 bnft - benefit{Space}
 tg - thing{Space}
 gltch - glitch{Space}
 tkg - taking{Space}
 tkg - taking{Space}
 tlkg - talking{Space}
 tlkg - talking{Space}
 tnkg - thinking{Space}
 mtg - meeting{Space}
 mngt - management{Space}
 th - this{Space}
 tbh - to be honest{Space}
 thnk - think{Space}
 hvnt - haven't{Space}
 it - it{Space}
 aight - aight{Space}
 intal - initial{Space}
 anti - anti
 bit - bit{Space}
 itd - it'd{Space}
 imdt - immediate{Space}
 dint - didn't{Space}
 igt - {BackSpace}ight{Space}
 tigh - tight{Space}
 light - light{Space}
 night - night{Space}
 intg - interesting{Space}
 thi - I think{Space}
 itch - itch{Space}
 think - think{Space}
 intl - internal{Space}
 int - interest{Space}
 ito - in terms of{Space}
 ation - {BackSpace}ation{Space}
 intol - international{Space}
 into - into{Space}
 positn - position{Space}
 its - it's{Space}
 distnc - distinct{Space}
 sight - sight{Space}
 this - this{Space}
 this - this{Space}
 stick - stick{Space}
 stil - still{Space}
 inst - instead{Space}
 intv - interview{Space}
 izt - ization
 tk - take{Space}
 tlk - talk{Space}
 mkt - market{Space}
 blt - built{Space}
 tcnl - technical{Space}
 mntl - mental{Space}
 xlnt - excellent{Space}
 tm - time{Space}
 mnt - minute{Space}
 to - to{Space}
 to - too{Space}
 conta - contact{Space}
 altho - although{Space}
 toal - total{Space}
 botm - bottom{Space}
 cont - contract{Space}
 told - told{Space}
 dont - don't{Space}
 got - got{Space}
 tho - though{Space}
 both - both{Space}
 month - month{Space}
 tok - took{Space}
 lot - lot{Space}
 not - not{Space}
 not - not{Space}
 top - top{Space}
 adopt - adopt{Space}
 phot - photo{Space}
 stop - stop{Space}
 optmz - optimize{Space}
 cost - cost{Space}
 lost - lost{Space}
 most - most{Space}
 pt - point{Space}
 platfm - platform{Space}
 plant - plant{Space}
 past - past{Space}
 cpt - corporate{Space}
 cmpnt - component{Space}
 dpt - department{Space}
 mltp - multiple{Space}
 ptnl - potential{Space}
 pst - post{Space}
 pstn - postpone{Space}
 pstv - positive{Space}
 ts - its{Space}
 st - st
 dsnt - doesn't{Space}
 sgnft - significant{Space}
 tgs - things{Space}
 shdnt - shouldn't{Space}
 mstk - mistake{Space}
 lst - list{Space}
 lstn - listen{Space}
 tmslv - themselves{Space}
 smt - sometimes{Space}
 snt - essentially{Space}
 uat - uation
 taugh - taught{Space}
 actul - actual{Space}
 but - but{Space}
 cut - cut{Space}
 until - until{Space}
 situaon - situation{Space}
 duplict - duplicate{Space}
 ult - ultimately{Space}
 out - out{Space}
 auto - auto{Space}
 acount - account{Space}
 buton - button{Space}
 count - count{Space}
 touch - touch{Space}
 mouth - mouth{Space}
 custom - custom{Space}
 put - put{Space}
 stuf - stuff{Space}
 must - must{Space}
 ctx - context{Space}
 ty - thank you{Space}
 stay - stay{Space}
 vastly - vastly{Space}
 tdy - today{Space}
 ity - {BackSpace}ity{Space}
 activy - activity{Space}
 ality - {BackSpace}ality{Space}
 abilty - ability{Space}
 idnty - identity{Space}
 kity - kitty{Space}
 ilty - ility{Space}
 iblty - ibility{Space}
 toy - toy{Space}
 toaly - totally{Space}
 hyptcl - hypothetical{Space}
 typcl - typical{Space}
 tyvm - thank you very much{Space}
 gotach - got you.{Space}
 path - path{Space}
 sct - society{Space}
 tmslv - themselves{Space}
 sutain - sustain{Space}
 instuo - institution{Space}
 thoug - thought{Space}
 ntv - native{Space}
 city - city{Space}
 acy - {BackSpace}acy{Space}
 day - day{Space}
 ugly - ugly{Space}
 styg - staying{Space}
 agency - agency{Space}
 cy - {BackSpace}cy{Space}
 anybd - anybody{Space}
 gdby - goodbye{Space}
 pyg - paying{Space}
 vnyd - vineyard{Space}
 baly - {backspace}ably{Space}
 cnvy - convey{Space}
 fly - fly{Space}
 holy - holy{Space}
 hypo - hypo
 nlys - analysis{Space}
 budy - buddy{Space}
 guys - guys{Space}
 bay - baby{Space}
 onclgy - oncology{Space}
 play - play{Space}
 myns - mayonnaise{Space}
 ulyj - July{Space}
 copy - copy{Space}
 physcn - physician{Space}
 may - may{Space}
 nclgy - oncology{Space}
 onclgy - oncology{Space}
 bynd - beyond{Space}
 ify - {BackSpace}ify{Space}
 joy - joy{Space}
 physcl - physical{Space}
 any - any{Space}
 many - many{Space}
 say - say{Space}
 sayg - saying{Space}
 by - by{Space}
 yd - yesterday{Space}
 fnly - finally{Space}
 daily - daily{Space}
 family - family{Space}
 anlysi - analysis{Space}
 ify - ify{Space}
 ily - {BackSpace}ily{Space}
 yk - you know{Space}
 ly - {BackSpace}ly{Space}
 my - my{Space}
 anoy - annoy{Space}
 anymo - anymore{Space}
 boy - boy{Space}
 body - body{Space}
 only - only{Space}
 pay - pay{Space}
 hapy - happy{Space}
 play - play{Space}
 cmpy - completely{Space}
 days - days{Space}
 syg - saying{Space}
 sym - sym
 syn - syn
 usaly - usually{Space}
 buy - buy{Space}
 guy - guy{Space}
 young - young{Space}
 lay - lay{Space}
 funy - funny{Space}
 busy - busy{Space}
 au - au
 abu - a bunch{Space}
 human - human{Space}
 husband - husband{Space}
 minu - minimum{Space}
 counil - council{Space}
 bound - bound{Space}
 docu - docu
 launch - launch{Space}
 husban - husband{Space}
 duh - duh{Space}
 gun - gun{Space}
 bunch - bunch{Space}
 cauio - caution{Space}
 bump - bump{Space}
 manu - manu{Space}
 fuck - fuck{Space}
 luck - luck{Space}
 discu - discuss{Space}
 usg - using{Space}
 sung - sung{Space}
 album - albums{Space}
 solui - solution{Space}
 aud - audience{Space}
 aug - aug{Space}
 laugh - laugh{Space}
 laug - laugh{Space}
 launch - launch{Space}
 usal - usual{Space}
 cmu - communicate{Space}
 ud - you'd{Space}
 und - understand{Space}
 ful - full{Space}
 much - much{Space}
 cmui - communication{Space}
 comui - communication{Space}
 indu - industry{Space}
 uni - uni
 funcio - function{Space}
 ious - ious
 consiu - conscious{Space}
 conlusi - conclusion{Space}
 dupli - dupli{Space}
 music - music{Space}
 insu - insurance{Space}
 univ - university{Space}
 ul - you'll{Space}
 un - un
 num - number{Space}
 ou - ou
 found - found{Space}
 loud - loud{Space}
 cloud - cloud{Space}
 ough - ough{Space}
 pou - population{Space}
 upon - upon{Space}
 ous - {BackSpace}ous{Space}
 sound - sound{Space}
 focus - focus{Space}
 somu - so much{Space}
 up - up{Space}
 campus - campus{Space}
 cpu - computer{Space}
 jump - jump{Space}
 pul - pull{Space}
 push - push{Space}
 us - us{Space}
 sub - sub
 usf - yourself{Space}
 such - such{Space}
 sun - sun{Space}
 uv - you've{Space}
 fund - fund{Space}
 fun - fun{Space}
 uslf - yourself{Space}
 ea - ea
 capble - capable{Space}
 held - held{Space}
 rive - river{Space}
 premiu - premium{Space}
 fet - feet{Space}
 eir - {BackSpace}ier{Space}
 therapy - therapy{Space}
 merica - America{Space}
 urope - Europe{Space}
 leson - lesson{Space}
 plane - plane{Space}
 canel - cancel{Space}
 places - places{Space}
 lane - lane{Space}
 pleasnt - pleasant{Space}
 ase - assess{Space}
 surpie - surprise{Space}
 safe - safe{Space}
 chef - chef{Space}
 nuclear - nuclear{Space}
 alive - alive{Space}
 easily - easily{Space}
 insae - insane{Space}
 knife - knife{Space}
 niche - niche{Space}
 hike - hike{Space}
 lie - lie{Space}
 incle - incline{Space}
 econmi - economic{Space}
 income - income{Space}
 pencil - pencil{Space}
 slide - slide{Space}
 knives - knives{Space}
 smile - smile{Space}
 seiz - seize{Space}
 kne - knee{Space}
 bel - bell{Space}
 dobea - Adobe{Space}
 molase - molasses{Space}
 cofe - coffee{Space}
 condes - condense{Space}
 leson - lesson{Space}
 nose - nose{Space}
 ape - ape{Space}
 pen - pen{Space}
 spel - spell{Space}
 bear - bear{Space}
 regad - regard{Space}
 declar - declare{Space}
 fear - fear{Space}
 fear - fear{Space}
 relax - relax{Space}
 eras - erase{Space}
 ecmbrd - December{Space}
 fre - free{Space}
 cher - cheer{Space}
 raise - raise{Space}
 bride - bride{Space}
 bridge - bridge{Space}
 ridle - riddle{Space}
 iner - inner{Space}
 comprise - comprise{Space}
 prescib - prescribe{Space}
 mer - mere{Space}
 ero - error{Space}
 hoarse - hoarse{Space}
 comer - commerce{Space}
 broke - broke{Space}
 rose - rose{Space}
 censor - censor{Space}
 ovembrn - November{Space}
 spare - spare{Space}
 targe - target{Space}
 genrat - generate{Space}
 interac - interact{Space}
 cigaret - cigarette{Space}
 inhert - inherent{Space}
 orient - orient{Space}
 practie - practice{Space}
 rotae - rotate{Space}
 ctober - October{Space}
 stroke - stroke{Space}
 eptmbrs - September{Space}
 remunat - remunerate{Space}
 cemtry - cemetery{Space}
 proety - property{Space}
 edur - educator{Space}
 burden - burden{Space}
 urine - urine{Space}
 pronuce - pronounce{Space}
 rescu - rescue{Space}
 revnu - revenue{Space}
 acesory - accessory{Space}
 schem - scheme{Space}
 smel - smell{Space}
 atend - attend{Space}
 agent - agent{Space}
 tange - tangent{Space}
 talen - talent{Space}
 meant - meant{Space}
 stake - stake{Space}
 length - length{Space}
 technial - technical{Space}
 nomiate - nominate{Space}
 tensio - tension{Space}
 tensio - tension{Space}
 botle - bottle{Space}
 botle - bottle{Space}
 clothes - clothes{Space}
 plate - plate{Space}
 aspect - aspect{Space}
 step - steep{Space}
 sentc - sentence{Space}
 tube - tube{Space}
 chute - chute{Space}
 mute - mute{Space}
 outcme - outcome{Space}
 upset - upset{Space}
 ecosytm - ecosystem{Space}
 judge - judge{Space}
 nudge - nudge{Space}
 unej - June{Space}
 pulse - pulse{Space}
 agency - agency{Space}
 yep - yep{Space}
 rlty - reality{Space}
 meant - meant{Space}
 sane - sane{Space}
 insae - insane{Space}
 sped - sped{Space}
 ce - {BackSpace}{BackSpace}ce{Space}
 tune - tune{Space}
 force - force{Space}
 asocite - associate{Space}
 menio - mention{Space}
 hey - hey{Space}
 yep - yep{Space}
 comend - commend{Space}
 intes - intense{Space}
 eruios - capable{Space}
 valube - valuable{Space}
 navigte - navigate{Space}
 scare - scare{Space}
 remot - remote{Space}
 nterlx - internal{Space}
 proces - process{Space}
 becam - became{Space}
 chaleng - challenge{Space}
 taken - taken{Space}
 atemp - attempt{Space}
 vein - vein{Space}
 phrase - phrase{Space}
 transpe - transparent{Space}
 dea - dead{Space}
 handle - handle{Space}
 began - began{Space}
 shake - shake{Space}
 evdnc - evidence{Space}
 disea - disease{Space}
 aisle - aisle{Space}
 vehicl - vehicle{Space}
 mile - mile{Space}
 emoi - emotion{Space}
 insde - inside{Space}
 shine - shine{Space}
 silenc - silence{Space}
 lake - lake{Space}
 alone - alone{Space}
 conve - convene{Space}
 lodge - lodge{Space}
 clone - clone{Space}
 lemon - lemon{Space}
 melon - melon{Space}
 poke - poke{Space}
 solve - solve{Space}
 solve - solve{Space}
 cheap - cheap{Space}
 grade - grade{Space}
 frame - frame{Space}
 charge - charge{Space}
 manger - manager{Space}
 rec - rec recognize{Space}
 herd - herd{Space}
 emrgnc - emergency{Space}
 merg - merge{Space}
 earli - earlier{Space}
 miracle - miracle{Space}
 fire - fire{Space}
 senior - senior{Space}
 riple - ripple{Space}
 princle - principle{Space}
 inspre - inspire{Space}
 levr - lever{Space}
 ern - {backspace}ern{Space}
 core - core{Space}
 core - core{Space}
 hero - hero{Space}
 holer - holler{Space}
 score - score{Space}
 closer - closer{Space}
 tear - tear{Space}
 trade - trade{Space}
 edtr - editor{Space}
 neithr - neither{Space}
 elctri - electric{Space}
 editor - editor{Space}
 practie - practice{Space}
 practie - practice{Space}
 theirs - theirs{Space}
 rejct - reject{Space}
 elctr - electric{Space}
 forgten - forgotten{Space}
 prevnt - prevent{Space}
 recuit - recruit{Space}
 turle - turtle{Space}
 retun - return{Space}
 route - route{Space}
 argue - argue{Space}
 asure - assure{Space}
 bumer - bummer{Space}
 counselr - counselor{Space}
 nervous - nervous{Space}
 nurse - nurse{Space}
 shel - shell{Space}
 stae - state{Space}
 bet - bet{Space}
 bet - bet{Space}
 tend - tend{Space}
 efcnt - efficient{Space}
 efcnt - efficient{Space}
 kitchen - kitchen{Space}
 inteo - intention{Space}
 emotin - emotion{Space}
 indept - independent{Space}
 ntiles - nationalities{Space}
 evltt - evaluate{Space}
 poet - poet{Space}
 planet - planet{Space}
 exmpt - exempt{Space}
 setg - setting{Space}
 gets - gets{Space}
 esntl - essential{Space}
 evalut - evaluate{Space}
 subtance - substance{Space}
 instue - institute{Space}
 plenty - plenty{Space}
 gaue - gauge{Space}
 vague - vague{Space}
 abuse - abuse{Space}
 hue - hue{Space}
 influec - influence{Space}
 suicde - suicide{Space}
 counsel - counsel{Space}
 pudle - puddle{Space}
 ey - eye{Space}
 delay - delay{Space}
 eficay - efficacy{Space}
 yel - yell{Space}
 convey - convey{Space}
 inspre - inspire{Space}
 spoke - spoke{Space}
 leap - leap{Space}
 expnd - expend{Space}
 arive - arrive{Space}
 proe - proper{Space}
 deprc - deprec{Space}
 interp - interpret{Space}
 interup - interrupt{Space}
 elimnat - eliminate{Space}
 instace - instance{Space}
 scient - scientist{Space}
 invte - invite{Space}
 produe - produce{Space}
 came - came{Space}
 dance - dance{Space}
 drume - drummer{Space}
 false - false{Space}
 sale - sale{Space}
 scale - scale{Space}
 edg - edge{Space}
 bef - beef{Space}
 vice - vice{Space}
 dive - dive{Space}
 engi - engine{Space}
 mine - mine{Space}
 convie - convince{Space}
 noise - noise{Space}
 cel - cell{Space}
 hone - hone{Space}
 dream - dream{Space}
 adres - address{Space}
 degr - degree{Space}
 encrg - encourage{Space}
 hire - hire{Space}
 cirle - circle{Space}
 presnc - presence{Space}
 tire - tire{Space}
 practie - practice{Space}
 elctrn - electronic{Space}
 conert - concert{Space}
 efort - effort{Space}
 protec - protect{Space}
 exprt - expert{Space}
 routine - routine{Space}
 route - route{Space}
 course - course{Space}
 course - course{Space}
 secur - secure{Space}
 secur - secure{Space}
 rely - rely{Space}
 scen - scene{Space}
 seg - seeing{Space}
 beat - beat{Space}
 date - date{Space}
 date - date{Space}
 death - death{Space}
 metal - metal{Space}
 thef - theft{Space}
 dictae - dictate{Space}
 inte - intent{Space}
 comite - committee{Space}
 invet - invent{Space}
 goten - gotten{Space}
 conset - consent{Space}
 vote - vote{Space}
 excpt - except{Space}
 update - update{Space}
 yet - yet{Space}
 beauty - beauty{Space}
 langue - language{Space}
 asume - assume{Space}
 suicde - suicide{Space}
 blue - blue{Space}
 menu - menu{Space}
 menu - menu{Space}
 pause - pause{Space}
 dancer - dancer{Space}
 enga - engage{Space}
 emoi - emotion{Space}
 above - above{Space}
 joke - joke{Space}
 dep - deep{Space}
 gren - green{Space}
 remain - remain{Space}
 prove - prove{Space}
 pref - prefer{Space}
 heart - heart{Space}
 breath - breathe{Space}
 arent - aren't{Space}
 iterao - iteration{Space}
 iterao - iteration{Space}
 practie - practice{Space}
 parent - parent{Space}
 enrgy - energy{Space}
 send - send{Space}
 stage - stage{Space}
 stage - stage{Space}
 opsite - opposite{Space}
 elmnt - element{Space}
 colet - collect{Space}
 note - note{Space}
 cute - cute{Space}
 suget - suggest{Space}
 evnt - event{Space}
 theyd - they'd{Space}
 theyl - theyll{Space}
 cause - cause{Space}
 anouce - announce{Space}
 suced - succeed{Space}
 suced - succeed{Space}
 unles - unless{Space}
 enjoy - enjoy{Space}
 esp - especially{Space}
 acen - {BackSpace}ance{Space}
 head - head{Space}
 lead - lead{Space}
 made - made{Space}
 face - face{Space}
 femal - female{Space}
 fame - fame{Space}
 age - age{Space}
 change - change{Space}
 chaleng - challenge{Space}
 game - game{Space}
 mange - manage{Space}
 gave - gave{Space}
 each - each{Space}
 chane - chance{Space}
 heal - heal{Space}
 have - have{Space}
 make - make{Space}
 able - able{Space}
 clean - clean{Space}
 male - male{Space}
 lean - lean{Space}
 name - name{Space}
 base - base{Space}
 case - case{Space}
 asked - asked{Space}
 safe - safe{Space}
 makes - makes{Space}
 same - same{Space}
 save - save{Space}
 be - be{Space}
 nec - necessary{Space}
 cen - {BackSpace}ence{Space}
 ed - {BackSpace}ed{Space}
 dec - dec{Space}
 def - definitely{Space}
 led - led{Space}
 ned - need{Space}
 end - end{Space}
 dev - develop{Space}
 fe - for example{Space}
 eg - everything{Space}
 beg - being{Space}
 leg - leg{Space}
 he - he{Space}
 chek - check{Space}
 vacine - vaccine{Space}
 idea - idea{Space}
 media - media{Space}
 imagne - imagine{Space}
 email - email{Space}
 ice - ice{Space}
 nice - nice{Space}
 ide - ide
 deci - decide{Space}
 field - field{Space}
 field - field{Space}
 defin - define{Space}
 midle - middle{Space}
 inde - indeed{Space}
 life - life{Space}
 begin - begin{Space}
 begin - beginning{Space}
 eibl - {BackSpace}ible{Space}
 live - live{Space}
 voice - voice{Space}
 video - video{Space}
 ofice - office{Space}
 choie - choice{Space}
 invole - involve{Space}
 secio - section{Space}
 noise - noise{Space}
 pie - pipe{Space}
 piec - piece{Space}
 eis - {BackSpace}ies{Space}
 since - since{Space}
 side - side{Space}
 single - single{Space}
 vei - I've{Space}
 eiz - {BackSpace}ize{Space}
 neck - neck{Space}
 necl - necessarily{Space}
 lev - level{Space}
 me - me{Space}
 en - {BackSpace}en{Space}
 men - men{Space}
 seaon - season{Space}
 eco - eco{Space}
 once - once{Space}
 code - code{Space}
 model - model{Space}
 done - done{Space}
 enog - enough{Space}
 goneuh - gone{Space}
 hole - hole{Space}
 home - home{Space}
 love - love{Space}
 one - one{Space}
 peo - people{Space}
 devlop - develop{Space}
 hope - hope{Space}
 phone - phone{Space}
 open - open{Space}
 pose - pose{Space}
 phones - phones{Space}
 does - does{Space}
 goes - goes{Space}
 shoe - shoe{Space}
 chose - chose{Space}
 lose - lose{Space}
 close - close{Space}
 some - some{Space}
 evo - everyone{Space}
 zone - zone{Space}
 pace - pace{Space}
 page - page{Space}
 peak - peak{Space}
 place - place{Space}
 space - space{Space}
 shape - shape{Space}
 speak - speak{Space}
 pleas - please{Space}
 depn - depend{Space}
 help - help{Space}
 kep - keep{Space}
 spec - spec{Space}
 specl - specifically{Space}
 spend - spend{Space}
 shep - sheep{Space}
 slep - sleep{Space}
 exp - experience{Space}
 er - {BackSpace}er{Space}
 are - are{Space}
 care - care{Space}
 camer - camera{Space}
 fedral - federal
 heard - heard{Space}
 ready - ready{Space}
 agre - agree{Space}
 hearg - hearing{Space}
 large - large{Space}
 range - range{Space}
 hear - hear{Space}
 reach - reach{Space}
 break - break{Space}
 real - real{Space}
 clear - clear{Space}
 learn - learn{Space}
 near - near{Space}
 share - share{Space}
 search - search{Space}
 mebr - member{Space}
 fre - free{Space}
 her - her{Space}
 raise - raise{Space}
 friend - friend{Space}
 delivr - deliver{Space}
 delivr - deliver{Space}
 remind - remind{Space}
 deriv - derive{Space}
 brief - brief{Space}
 infer - infer{Space}
 engir - engineer{Space}
 region - region{Space}
 operai - operation{Space}
 provide - provide{Space}
 scenrio - scenario{Space}
 descrio - description{Space}
 enviro - environment{Space}
 price - price{Space}
 scribe - scribe{Space}
 descri - describe{Space}
 reason - reason{Space}
 coner - concern{Space}
 cover - cover{Space}
 orde - order{Space}
 recod - record{Space}
 ofer - offer{Space}
 role - role{Space}
 compare - compare{Space}
 perfomanc - performance{Space}
 problem - problem{Space}
 explor - explore{Space}
 proges - progress{Space}
 person - person{Space}
 horse - horse{Space}
 over - over{Space}
 per - per{Space}
 prea - prepare{Space}
 replac - replace{Space}
 pres - press{Space}
 res - res{Space}
 scren - screen{Space}
 serv - serve{Space}
 tre - tree{Space}
 rate - rate{Space}
 react - react{Space}
 father - father{Space}
 great - great{Space}
 charte - character{Space}
 later - later{Space}
 central - central{Space}
 mater - matter{Space}
 extra - extra
 betr - better{Space}
 recnt - recent{Space}
 ther - there{Space}
 thers - there's{Space}
 certain - certain{Space}
 integra - integrate{Space}
 retail - retail{Space}
 vertical - vertical{Space}
 relativ - relative{Space}
 credit - credit{Space}
 filter - filter{Space}
 their - their{Space}
 inter - inter
 cordinate - coordinate{Space}
 terapi - therapist{Space}
 therapi - therapist{Space}
 therapis - therapist{Space}
 therpi - therapist{Space}
 siter - sister{Space}
 letr - letter{Space}
 term - term{Space}
 entr - enter{Space}
 tore - tore{Space}
 storage - storage{Space}
 coret - correct{Space}
 togehr - together{Space}
 other - other{Space}
 bother - bother{Space}
 mother - mother{Space}
 repot - report{Space}
 store - store{Space}
 tesorn - testosterone{Space}
 parte - parate{Space}
 partne - partner{Space}
 percnt - percent{Space}
 presnt - present{Space}
 rest - rest{Space}
 thers - there's{Space}
 true - true{Space}
 acurte - accurate{Space}
 manufctre - manufacture{Space}
 nature - nature{Space}
 curent - current{Space}
 futre - future{Space}
 picture - picture{Space}
 cultre - culture{Space}
 result - result{Space}
 envrmt - environment{Space}
 extrm - extreme{Space}
 theyr - they're{Space}
 entry - entry{Space}
 ure - you're{Space}
 reduc - reduce{Space}
 under - under{Space}
 rule - rule{Space}
 purose - purpose{Space}
 super - super{Space}
 sure - sure{Space}
 urself - yourself{Space}
 sumer - summer{Space}
 evr - ever{Space}
 nevr - never{Space}
 nevr - never{Space}
 ery - every{Space}
 early - early{Space}
 grocey - grocery{Space}
 hyper - hyper
 surgey - surgery{Space}
 evry - every{Space}
 se - see{Space}
 sec - second{Space}
 send - send{Space}
 self - self{Space}
 she - she{Space}
 sek - seek{Space}
 els - else{Space}
 eslv - {BackSpace}selves{Space}
 sem - seem{Space}
 sen - sense{Space}
 et - even though{Space}
 ate - ate{Space}
 hated - hated{Space}
 dental - dental{Space}
 afect - affect{Space}
 teachg - teaching{Space}
 hate - hate{Space}
 teach - teach{Space}
 healt - health{Space}
 take - take{Space}
 late - late{Space}
 table - table{Space}
 team - team{Space}
 neat - neat{Space}
 stae - state{Space}
 stance - stance{Space}
 least - least{Space}
 exact - exact{Space}
 etc - et cetera{Space}
 cent - cent{Space}
 tend - tend{Space}
 efct - effect{Space}
 felt - felt{Space}
 get - get{Space}
 evtg - everything{Space}
 the - the{Space}
 tech - tech{Space}
 techn - technology{Space}
 them - them{Space}
 then - then{Space}
 active - active{Space}
 ative - ative
 intelgc - intelligence{Space}
 intelg - intelligent{Space}
 ethic - ethic{Space}
 lite - little{Space}
 client - client{Space}
 item - item{Space}
 time - time{Space}
 comite - committee{Space}
 notice - notice{Space}
 mentio - mention{Space}
 patien - patient{Space}
 site - site{Space}
 ites - ities{Space}
 times - times{Space}
 invest - invest{Space}
 exist - exist{Space}
 tive - tive{Space}
 excit - excite{Space}
 let - let{Space}
 met - met{Space}
 met - met{Space}
 net - net{Space}
 emnt - {BackSpace}ment{Space}
 locate - locate{Space}
 conet - connect{Space}
 coment - comment{Space}
 often - often{Space}
 togeh - together{Space}
 hotel - hotel{Space}
 object - object{Space}
 moent - moment{Space}
 conept - concept{Space}
 pocket - pocket{Space}
 those - those{Space}
 honest - honest{Space}
 acept - accept{Space}
 depnt - dependent{Space}
 kept - kept{Space}
 step - step{Space}
 step - step{Space}
 spent - spent{Space}
 xpct - expect{Space}
 set - set{Space}
 best - best{Space}
 thes - these{Space}
 chest - chest{Space}
 estblh - establish{Space}
 lets - let's{Space}
 selct - select{Space}
 sent - sent{Space}
 sentyl - sent{Space}
 educat - educate{Space}
 augment - augment{Space}
 minute - minute{Space}
 duplicate - duplicate{Space}
 document - document{Space}
 studen - student{Space}
 evntu - eventually{Space}
 ext - external{Space}
 next - next{Space}
 they - they{Space}
 theyv - they've{Space}
 identy - identity{Space}
 ecosytm - ecosystem{Space}
 type - type{Space}
 style - style{Space}
 sytem - system{Space}
 cleagu - colleague{Space}
 value - value{Space}
 edu - education{Space}
 huge - huge{Space}
 audienc - audience{Space}
 isue - issue{Space}
 supoe - suppose{Space}
 confuse - confuse{Space}
 house - house{Space}
 use - use{Space}
 suce - success{Space}
 suden - sudden{Space}
 gues - guess{Space}
 uve - you've{Space}
 ev - ever{Space}
 evb - everybody{Space}
 evn - even{Space}
 ex - exactly{Space}
 ex - ex
 exc - excellent{Space}
 anlyze - analyze{Space}
 easy - easy{Space}
 bye - bye{Space}
 key - key{Space}
 cyle - cycle{Space}
 money - money{Space}
 yes - yes{Space}
 myself - myself{Space}
 myself - myself{Space}
 evy - every{Space}
 blame - blame{Space}
 leas - lease{Space}
 deck - deck{Space}
 maner - manner{Space}
 frel - freelance{Space}
 period - period{Space}
 expir - expire{Space}
 precd - precede{Space}
 entrai - entertain{Space}
 edit - edit{Space}
 elct - elect{Space}
 guide - guide{Space}
 genui - genuine{Space}
 legacy - legacy{Space}
 ao - anyone{Space}
 ano - anyone{Space}
 load - load{Space}
 among - among{Space}
 fold - fold{Space}
 mgo - Oh my god.{Space}
 alcoh - alcohol{Space}
 gold - gold{Space}
 bold - bold{Space}
 cold - cold{Space}
 folk - folk{Space}
 log - log{Space}
 zom - zoom{Space}
 hmgos - Oh my gosh.{Space}
 gosh - gosh{Space}
 son - soon{Space}
 loan - loan{Space}
 bom - bomb{Space}
 shock - shock{Space}
 box - box{Space}
 ago - ago{Space}
 son - son{Space}
 goal - goal{Space}
 along - along{Space}
 gona - going to{Space}
 also - also{Space}
 co - could{Space}
 com - com
 con - con
 comn - common{Space}
 do - do{Space}
 doc - document{Space}
 fod - food{Space}
 dog - doing{Space}
 hold - hold{Space}
 old - old{Space}
 dom - {BackSpace}dom{Space}
 of - of{Space}
 ofc - of course{Space}
 ofc - of course{Space}
 conf - confirm{Space}
 nfo - information{Space}
 go - go{Space}
 long - long{Space}
 lovg - loving{Space}
 gon - gone{Space}
 hom - homo
 job - job{Space}
 ko - kind of{Space}
 bok - book{Space}
 cok - cook{Space}
 lok - look{Space}
 lock - lock{Space}
 onl - online{Space}
 on - on{Space}
 mon - moon{Space}
 op - opportunity{Space}
 opn - open{Space}
 ops - opportunities{Space}
 shop - shop{Space}
 so - so{Space}
 sof - sort of{Space}
 folks - folks{Space}
 song - song{Space}
 schol - school{Space}
 som - someone{Space}
 son - soon{Space}
 obv - obviously{Space}
 loca - local{Space}
 ofcl - official{Space}
 ho - Oh,{Space}
 sold - sold{Space}
 cap - cap{Space}
 kp - keep{Space}
 pudg - pudding{Space}
 spcf - specific{Space}
 hlpf - helpful{Space}
 hlp - helpful{Space}
 pack - pack{Space}
 map - map{Space}
 spam - spam{Space}
 pkg - package{Space}
 kp - keep{Space}
 apl - application{Space}
 pb - possible{Space}
 gap - gap{Space}
 apls - applies{Space}
 cmpn - companion{Space}
 xpnd - expand{Space}
 pkg - package{Space}
 cmpln - complain{Space}
 cmpln - complain{Space}
 dspn - dispense{Space}
 xpnsv - expansive{Space}
 ap - app{Space}
 aplgz - apologize{Space}
 acmpl - accomplish{Space}
 acmplsh - accomplish{Space}
 spk - speak{Space}
 mpsbl - impossible{Space}
 xps - expose{Space}
 plan - plan{Space}
 pas - pass{Space}
 hpf - hopefully{Space}
 hp - hope{Space}
 spcl - special{Space}
 cmp - company{Space}
 pdmc - pandemic{Space}
 pf - perfect{Space}
 hpf - hopefully{Space}
 pg - page{Space}
 hpg - happening{Space}
 pblg - publishing{Space}
 hpn - happen{Space}
 jmp - jump{Space}
 pl - people{Space}
 pbl - possibly{Space}
 cpl - couple{Space}
 pblc - public{Space}
 cmpl - complete{Space}
 xmpl - example{Space}
 xpln - explain{Space}
 np - no problem{Space}
 sp - specifically{Space}
 cmps - companies{Space}
 spd - speed{Space}
 hsp - hospital{Space}
 pls - please{Space}
 psbl - possible{Space}
 smpl - simple{Space}
 psn - passion{Space}
 xp - experience{Space}
 pblsh - publish{Space}
 ab - about{Space}
 avd - avoid{Space}
 advnc - advance{Space}
 sack - sack{Space}
 ban - banana{Space}
 fav - favorite{Space}
 ac - actually{Space}
 glad - glad{Space}
 band - band{Space}
 land - land{Space}
 damn - damn{Space}
 hang - hang{Space}
 bankg - banking{Space}
 calm - calm{Space}
 scan - scan{Space}
 hands - hands{Space}
 admsn - admission{Space}
 acdm - academic{Space}
 acdm - academic{Space}
 advc - advice{Space}
 advc - advice{Space}
 mad - mad{Space}
 adv - advertise{Space}
 agnc - agency{Space}
 amng - among{Space}
 hack - hack{Space}
 hal - hall{Space}
 aln - alone{Space}
 ads - ads{Space}
 advs - advise{Space}
 cash - cash{Space}
 mas - mass{Space}
 avg - average{Space}
 achv - achieve{Space}
 black - black{Space}
 abv - above{Space}
 can - can{Space}
 dancg - dancing{Space}
 abd - anybody{Space}
 afd - afterwards{Space}
 acdg - according{Space}
 had - had{Space}
 hand - hand{Space}
 ald - already{Space}
 af - after{Space}
 afg - affecting{Space}
 half - half{Space}
 fal - fall{Space}
 ag - anything{Space}
 amg - amazing{Space}
 agn - again{Space}
 ack - {Backspace}ack{Space}
 back - back{Space}
 al - all{Space}
 lab - lab{Space}
 cal - call{Space}
 alm - almost{Space}
 avlb - available{Space}
 am - am{Space}
 an - an{Space}
 man - man{Space}
 as - as{Space}
 abs - absolutely{Space}
 askd - asked{Space}
 glas - glass{Space}
 has - has{Space}
 lash - lash{Space}
 ask - ask{Space}
 clas - class{Space}
 smal - small{Space}
 bank - bank{Space}
 ans - answer{Space}
 vax - vaccine{Space}
 maz - Amazon{Space}
 ad - ad{Space}
 bsn - business{Space}
 bsc - basic{Space}
 smh - somehow{Space}
 schdl - schedule{Space}
 sz - size{Space}
 cms - comes{Space}
 bsd - besides{Space}
 hsbnd - husband{Space}
 nsd - inside{Space}
 shl - she'll{Space}
 vsbl - visible{Space}
 sd - somebody{Space}
 cnsm - consume{Space}
 lcns - license{Space}
 lsn - lesson{Space}
 msn - mission{Space}
 msn - mission{Space}
 msv - massive{Space}
 vsn - vision{Space}
 dsc - describe{Space}
 cnfs - confuse{Space}
 slf - {BackSpace}self{Space}
 hsn - hasn't{Space}
 dcsn - decision{Space}
 dsgn - design{Space}
 sclmd - social media{Space}
 sf - For sure.{Space}
 sgnfc - significant{Space}
 mslf - myself{Space}
 sg - something{Space}
 msg - message{Space}
 sh - should{Space}
 shdn - shouldn't{Space}
 shn - shouldn't{Space}
 sh - should{Space}
 sl - sell{Space}
 scl - social{Space}
 bscl - basically{Space}
 slp - sleep{Space}
 vsl - visual{Space}
 sm - some{Space}
 sn - seen{Space}
 srvc - service{Space}
 st - street{Space}
 vs - versus{Space}
 xclsv - exclusive{Space}
 nbd - nobody{Space}
 cmd - command{Space}
 hndl - handle{Space}
 dmn - domain{Space}
 hndl - handle{Space}
 hndlg - handling{Space}
 cdn - couldn't{Space}
 cnd - candid{Space}
 mdcn - medicine{Space}
 hdn - hadn't{Space}
 ncld - include{Space}
 dvc - device{Space}
 fdbk - feedback{Space}
 fnd - found{Space}
 gd - good{Space}
 bgd - background{Space}
 bldg - building{Space}
 dmg - damage{Space}
 gnd - ground{Space}
 bhnd - behind{Space}
 dl - deal{Space}
 bld - build{Space}
 ncdbl - incredible{Space}
 mdcl - medical{Space}
 mdcl - medical{Space}
 md - made{Space}
 dn - done{Space}
 drg - during {Space}
 vd - everyday{Space}
 dvm - development{Space}
 xd - excited{Space}
 bf - before{Space}
 cmf - comfortable{Space}
 fnc - finance{Space}
 blf - belief{Space}
 bnfcl - beneficial{Space}
 hf - helpful{Space}
 flg - feeling{Space}
 fl - feel{Space}
 fncl - financial{Space}
 fnl - final{Space}
 fn - fine{Space}
 bg - being{Space}
 cg - coming{Space}
 gen - general{Space}
 chng - change{Space}
 blng - belong{Space}
 mgc - magic{Space}
 hg - having{Space}
 lkg - looking{Space}
 chlng - challenge{Space}
 mkg - making{Space}
 lg - learning{Space}
 clg - college{Space}
 gnl - general{Space}
 lvg - leaving{Space}
 gf - girlfriend{Space}
 gvn - given{Space}
 mg - making{Space}
 ng - nothing{Space}
 mng - manage{Space}
 gv - give{Space}
 vg - very good{Space}
 mvg - moving{Space}
 xg - exciting{Space}
 mgzn - magazine{Space}
 ch - choice{Space}
 chkn - chicken{Space}
 hl - he'll{Space}
 vhcl - vehicle{Space}
 mh - Mm-hmm.{Space}
 hv - have{Space}
 mchn - machine{Space}
 chnl - channel{Space}
 ai - ai
 difc - difficult{Space}
 mid - mid{Space}
 hinac - China{Space}
 sia - Asia{Space}
 animl - animal{Space}
 chain - chain{Space}
 aim - aim{Space}
 sail - sail{Space}
 via - via{Space}
 inklg - inkling{Space}
 oil - oil{Space}
 limbo - limbo{Space}
 chip - chip{Space}
 pil - pill{Space}
 spin - spin{Space}
 skil - skill{Space}
 mix - mix{Space}
 ain - {BackSpace}ian{Space}
 fail - fail{Space}
 impsbl - impossible{Space}
 aio - {BackSpace}ation{Space}
 avoid - avoid{Space}
 izg - {BackSpace}izing{Space}
 acid - acid{Space}
 magic - magic{Space}
 dig - dig{Space}
 inflc - influence{Space}
 kic - kick{Space}
 ink - ink{Space}
 min - mini{Space}
 domain - domain{Space}
 biod - biodegradable{Space}
 void - void{Space}
 imo - in my opinion{Space}
 solid - solid{Space}
 pis - piss{Space}
 slipg - slipping{Space}
 slip - slip{Space}
 slip - slip{Space}
 jail - jail{Space}
 gain - gain{Space}
 ib - no{Space}
 valid - valid{Space}
 naio - nation{Space}
 schim - schism{Space}
 basi - basis{Space}
 clasi - classic{Space}
 inch - inch{Space}
 kil - kill{Space}
 clin - clinic{Space}
 info - info{Space}
 iphn - iphone{Space}
 skin - skin{Space}
 mis - miss{Space}
 admin - admin{Space}
 admins - administrator{Space}
 img - image{Space}
 link - link{Space}
 admino - administration{Space}
 isn - isn't{Space}
 claim - claim{Space}
 main - main{Space}
 said - said{Space}
 di - did{Space}
 dif - different{Space}
 find - find{Space}
 child - child{Space}
 dki - I don't know{Space}
 kind - kind{Space}
 ind - individual{Space}
 mind - mind{Space}
 if - if{Space}
 fil - fill{Space}
 fix - fix{Space}
 gi - I guess{Space}
 big - big{Space}
 hig - high{Space}
 livg - living{Space}
 ing - {BackSpace}ing{Space}
 hil - hill{Space}
 him - him{Space}
 ki - I know{Space}
 blink - blink{Space}
 clik - click{Space}
 milk - milk{Space}
 li - I'll{Space}
 liv - live{Space}
 mi - I'm{Space}
 in - in{Space}
 in - in{Space}
 io - {BackSpace}tion{Space}
 acio - action{Space}
 locai - location{Space}
 join - join{Space}
 ion - {BackSpace}ion{Space}
 omni - omni
 opi - option{Space}
 opin - opinion{Space}
 sion - {BackSpace}sion{Space}
 ison - ision{Space}
 paid - paid{Space}
 painf - painful{Space}
 pain - pain{Space}
 flip - flip{Space}
 pig - pig{Space}
 pick - pick{Space}
 imp - important{Space}
 pshi - {BackSpace}ship{Space}
 skip - skip{Space}
 is - is{Space}
 dis - dis
 kids - kids{Space}
 finsh - finish{Space}
 sig - significant{Space}
 sign - sign{Space}
 his - his{Space}
 ish - {BackSpace}ish{Space}
 sick - sick{Space}
 mis - mis
 film - film{Space}
 lb - little bit{Space}
 cl - cool{Space}
 blnc - balance{Space}
 mnl - manual{Space}
 vlm - volume{Space}
 cln - clinical{Space}
 blnc - balance{Space}
 mlc - molecule{Space}
 ln - line{Space}
 lv - leave{Space}
 blv - believe{Space}
 xl - exactly{Space}
 xcln - excellence{Space}
 xc - executive{Space}
 xmn - examine{Space}
 xnm - expect{Space} 
 mv - move{Space}
 vn - even{Space}
 mb - maybe{Space}
 bf - boyfriend{Space}
 bn - been{Space}
 bsc - basic{Space}
 bscl - basically{Space}
 bc - because{Space}
 bcm - become{Space}
 cm - come{Space}
 cnfd - confidence{Space}
 cmbn - combine{Space}
 cmg - coming{Space}
 cn - can{Space}
 cmn - common{Space}
 cnv - conversation{Space}
 ck - {Backspace}ck{Space}
 lk - look{Space}
 knl - knowledge{Space}
 mk - make{Space}
 kn - know{Space}
 zm - zoom{Space}
 mn - mean{Space}
 r' - {BackSpace}r{Space}
 und. - understood{Space}
 ty. - {BackSpace}ty{Space}
 threw. - threw{Space}
 seion. - session{Space}
 vrs. - verse{Space}
 mon. - moon{Space}
 eir. - {BackSpace}{BackSpace}ier{Space}
 vrs' - verse{Space}
 salt. - salt{Space}
 earth. - earth{Space}
 su. - United States{Space}
 sound. - sounds{Space}
 last. - last{Space}
 ation. - {BackSpace}{BackSpace}ation{Space}
 sped. - speed{Space}
 ndia. - Indian{Space}
 sea. - sea{Space}
 list. - list{Space}
 arnge. - arrange{Space}
 per' - pepper{Space}
 pea. - pea{Space}
 ahed. - ahead{Space}
 anj. - January{Space}
 ecd. - December{Space}
 ebf. - February{Space}
 reign. - reign{Space}
 rein. - rein{Space}
 sore. - sore{Space}
 sevr. - severe{Space}
 inhert. - inherit{Space}
 relay. - relay{Space}
 steak. - steak{Space}
 them. - theme{Space}
 invet. - invent{Space}
 epts. - September{Space}
 setup. - setup{Space}
 sue. - sue{Space}
 sink. - sink{Space}
 ovn. - November{Space}
 archm. - March{Space}
 und. - understood{Space}
 raw. - raw{Space}
 aint' - aint{Space}
 aym. - May{Space}
 dah. - dah{Space}
 uga. - August{Space}
 thus. - thus{Space}
 cto. - October{Space}
 fscnt. - fascinate{Space}
 litera. - literal{Space}
 ain. - {BackSpace}{BackSpace}ian{Space}
 info. - information{Space}
 prcd. - procedure{Space}
 ion. - {BackSpace}{BackSpace}ion{Space}
 sad. - sad{Space}
 prgm. - programmer{Space}
 east' - east{Space}
 aio. - {BackSpace}{BackSpace}ation{Space}
 ent. - {BackSpace}ent{Space}
 escap. - escape{Space}
 bal. - ball{Space}
 won't - won't{Space}
 ok' - okay{Space}
 spel. - spell{Space}
 opse. - oppose{Space}
 easir. - easier{Space}
 tkn. - taken{Space}
 resach. - research{Space}
 nflc. - influence{Space}
 cnl. - council{Space}
 or. - {backspace}or{Space}
 mnt. - mountain{Space}
 fe. - fee{Space}
 prncl. - principal{Space}
 meat. - meat{Space}
 log. - logging{Space}
 zom. - zoom{Space}
 sqrt. - squirt{Space}
 ram. - ram{Space}
 grd. - grade{Space}
 nflc. - influence{Space}
 mngr. - manager{Space}
 rslv. - resolve{Space}
 nrvs. - nervous{Space}
 frgt. - forgot{Space}
 strg. - string{Space}
 wal. - wall{Space}
 sour. - sour{Space}
 slnc. - silence{Space}
 slv. - solve{Space}
 cat. - cat{Space}
 cnt. - contain{Space}
 acti. - {backspace}atic{Space}
 tain. - taint{Space}
 wo. - wow{Space}
 say. - says{Space}
 aply. - apply{Space}
 l' - {backspace}ll{Space}
 chng. - changing{Space}
 in. - in
 kid. - kid{Space}
 lng. - language lng.{Space}
 shel. - she'll{Space}
 ev' - {backspace}ve{Space}
 setg. - settings{Space}
 esc. - escape{Space}
 emrg. - emerge{Space}
 thorug. - thorough{Space}
 bael. - {backspace}able{Space}
 bael. - {backspace}able{Space}
 two' - two{Space}
 apel. - appeal{Space}
 est' - {BackSpace}{BackSpace}est{Space}
 er' - {backspace}re{Space}
 liase. - liaise{Space}
 brake. - brake{Space}
 mtv. - motivate{Space}
 rea. - rear{Space}
 drct. - direct{Space}
 era' - era{Space}
 ought. - ought{Space}
 d. - str ={backspace}d{Space}
 m.h - Mm-mmm.{Space}
 ing. - {backspace}{backspace}ing{Space}
 les. - less{Space}
 tena. - tenant{Space}
 frth. - further{Space}
 invt. - invite{Space}
 dens. - dense{Space}
 easir - easier{Space}
 ntrl. - natural{Space}
 repsnt. - represent{Space}
 ref. - refer{Space}
 eur. - {backspace}ure{Space}
 shet. - sheet{Space}
 no. - non{Space}
 intrp. - interrupt{Space}
 ast. - asset{Space}
 mscn. - musician{Space}
 vntg. - vintage{Space}
 rgst. - register{Space}
 vine. - vine{Space}
 tase. - taste{Space}
 nest. - nest{Space}
 ant. - {BackSpace}ant{Space}
 noe. - none{Space}
 apl. - appeal{Space}
 eis. - {BackSpace}{BackSpace}ies{Space}
 bas. - bass{Space}
 dbl. - double{Space}
 aeg. - {BackSpace}age{Space}
 cen. - {BackSpace}ence{Space}
 trea. - treat{Space}
 centr. - center{Space}
 eat. - eat{Space}
 ship. - ship{Space}
 prfs. - professor{Space}
 gtr. - guitar{Space}
 trbl. - terrible{Space}
 aprt. - appropriate{Space}
 prtc. - participate{Space}
 prtn. - partner{Space}
 truh. - truth{Space}
 ngt. - negotiation{Space}
 idnt. - identity{Space}
 hit. - hit{Space}
 pltc. - political{Space}
 stn. - situation{Space}
 ty. - YouTube{Space}
 w.n - No worries.{Space}
 bad. - bad{Space}
 bas. - bass{Space}
 fel. - fell{Space}
 five. - five{Space}
 nie. - nine{Space}
 eiv. - {BackSpace}ive{Space}
 em. - em{Space}
 earn. - earn{Space}
 thre. - three{Space}
 hes. - he's{Space}
 sevn. - seven{Space}
 eight. - eight{Space}
 tone. - tone{Space}
 six. - six{Space}
 apr. - appear{Space}
 four. - four{Space}
 til. - till{Space}
 shot. - shoot{Space}
 two. - two{Space}
 sort. - sort of{Space}
 go. - going{Space}
 shit. - shit{Space}
 mt. - might{Space}
 dif. - difficult{Space}
 dnt. - didn't{Space}
 dint. - didn't{Space}
 re. - re
 pre. - pre
 em. - them{Space}
 gi. - Instagram{Space}
 bf. - Facebook{Space}
 gl. - Google{Space}
 di. - I'd{Space}
 ok. - okay{Space}
 sm. - so much{Space}
 tec. - technology{Space}
 th. - th{Space}
 ths. - that's{Space}
 ve. - ve{Space}
 c. - see{Space}
 u. - you{Space}
 n. - and{Space}
 t. - the{Space}
 y. - yeah{Space}
 b. - but{Space}
 iton. - ition{Space}
 w. - with{Space}
 p. - pretty{Space}
 k. - know{Space}
 q. - quick{Space}
 g. - great{Space}
 l. - like{Space}
 r. - really{Space}
 sh. - sh{Space}
 j. - just{Space}
 m. - much{Space}
 e. - even{Space}
 d. - ed{Space}
 f. - for{Space}
 v. - very{Space}
 io. - {BackSpace}{BackSpace}tion{Space}
 th. - th{Space}
 ch. - ch{Space}
 to. - too{Space}
 aught. - aught{Space}
 con. - con{Space}
 are. - are{Space}
 gc. - seeing{Space}
 awy. - away{Space}
 saw. - saw{Space}
 3 - three{Space}
 1 - one{Space}
 2 - two{Space}
 4 - four{Space}
 5 - five{Space}
 ex. - exact{Space}
 6 - six{Space}
 7 - seven{Space}
 8 - eight{Space}
 9 - nine{Space}
 0 - 10{Space}
 who. - who{Space}
 tel. - tell{Space}
 stre. - stress{Space}
 st. - st{Space}
 post. - post{Space}
 sit. - sit{Space}
 shal. - shall{Space}
 sed. - seed{Space}
 saw. - saw{Space}
 own. - own{Space}
 on. - on{Space}
 left. - left{Space}
 thaw. - thaw{Space}
 of. - off{Space}
 name. - name{Space}
 evil. - evil{Space}
 pek. - peek{Space}
 hurt. - hurt{Space}
 hot. - hot{Space}
 ish. - ish{Space}
 her. - here{Space}
 og. - original{Space}
 de. - de
 post. - post
 mis. - mis{Space}
 al. - {BackSpace}al{Space}
 s. - {BackSpace}s{Space}
 ens. - {BackSpace}ness{Space}
 i. - I{Space}
 a. - a{Space}
 ful. - {BackSpace}ful{Space}
 re. - re
 oth. - oth{Space}
 ton. - ton{Space}
 aly. - {BackSpace}ally{Space}
 able. - able
 ua. - ua
 end. - end{Space}
 er. - {BackSpace}er
 met. - meet{Space}
 get. - getting{Space}
 al. - {BackSpace}al
 post. - post{Space}
 age. - age
 eithr. - either{Space}
 gv. - giving{Space}
 resach. - research{Space}
 fed. - feed{Space}
 chose. - choose{Space}
 begin. - beginning{Space}
 shop. - shops{Space}
 sem. - seems{Space}
 relat. - relate{Space}
 eits. - {BackSpace}ities{Space}
 tol. - tool{Space}
 staf. - staff{Space}
 sn. - season{Space}
 sing. - sing{Space}
 paer. - paper{Space}
 es. - {BackSpace}es{Space}
 depns. - depends{Space}
 crtl. - critical{Space}
 repsnt. - represent{Space}
 anlog. - analog{Space}
 lar. - lar
 atch. - attach{Space}
 parent. - parent{Space}
 igh. - igh{Space}
 tes. - test{Space}
 sent. - sent{Space}
 self. - self{Space}
 plea. - Apple{Space}
 scien. - science{Space}
 vrtl. - virtual{Space}
 st. - street{Space}
 dog. - dog{Space}
 inter. - internet{Space}
 crptn. - corporation{Space}
 witer. - Twitter{Space}
 race. - race{Space}
 user. - user{Space}
 car. - car{Space}
 broad. - broad{Space}
 awre. - aware{Space}
 worth. - worth{Space}
 farthe. - farther{Space}
 aply. - apply{Space}
 cptr. - capture{Space}
 presu. - pressure{Space}
 sel. - sell{Space}
 file. - file{Space}
 wake. - wake{Space}
 leadd. - lead{Space}
 we'r - we're{Space}
 he's - he's{Space}
 'di - I'd{Space}
 y'al - y'all{Space}
 't - {BackSpace}'t{Space}
 who's - who's{Space}
 din't - didn't{Space}
 n't - {BackSpace}n't{Space}
 'd - {BackSpace}'d{Space}
 t's - that's{Space}
 's - {BackSpace}'s{Space}
 l - {BackSpace}'ll{Space}
 ad. - add{Space}
 aces. - access{Space}
 ced. - {BackSpace}cede{Space}
 eis. - {BackSpace}ies{Space}
 evol. - evolve{Space}
 phase. - phase{Space}
 alter. - alter{Space}
 fl. - full{Space}
 itl. - it'll{Space}
 it'l - it'll{Space}
 pltn. - population{Space}
 mv. - movie{Space}
 q; - {BackSpace}{BackSpace}q{Space}
 w; - {BackSpace}{BackSpace}w{Space}
 e; - {BackSpace}{BackSpace}e{Space}
 r; - {BackSpace}{BackSpace}r{Space}
 t; - {BackSpace}{BackSpace}t{Space}
 y; - {BackSpace}{BackSpace}y{Space}
 u; - {BackSpace}{BackSpace}u{Space}
 i; - {BackSpace}{BackSpace}i{Space}
 o; - {BackSpace}{BackSpace}o{Space}
 p; - {BackSpace}{BackSpace}p{Space}
 a; - {BackSpace}{BackSpace}a{Space}
 s; - {BackSpace}{BackSpace}s{Space}
 d; - {BackSpace}{BackSpace}d{Space}
 f; - {BackSpace}{BackSpace}f{Space}
 g; - {BackSpace}{BackSpace}g{Space}
 h; - {BackSpace}{BackSpace}h{Space}
 j; - {BackSpace}{BackSpace}j{Space}
 k; - {BackSpace}{BackSpace}k{Space}
 l; - {BackSpace}{BackSpace}l{Space}
 z; - {BackSpace}{BackSpace}z{Space}
 x; - {BackSpace}{BackSpace}x{Space}
 c; - {BackSpace}{BackSpace}c{Space}
 v; - {BackSpace}{BackSpace}v{Space}
 b; - {BackSpace}{BackSpace}b{Space}
 n; - {BackSpace}{BackSpace}n{Space}
 m; - {BackSpace}{BackSpace}m{Space}
 q/ - {BackSpace}q{Space}
 w/ - {BackSpace}w{Space}
 e/ - {BackSpace}e{Space}
 r/ - {BackSpace}r{Space}
 t/ - {BackSpace}t{Space}
 y/ - {BackSpace}y{Space}
 u/ - {BackSpace}u{Space}
 i/ - {BackSpace}i{Space}
 o/ - {BackSpace}o{Space}
 p/ - {BackSpace}p{Space}
 a/ - {BackSpace}a{Space}
 s/ - {BackSpace}s{Space}
 d/ - {BackSpace}d{Space}
 f/ - {BackSpace}f{Space}
 g/ - {BackSpace}g{Space}
 h/ - {BackSpace}h{Space}
 j/ - {BackSpace}j{Space}
 k/ - {BackSpace}k{Space}
 l/ - {BackSpace}l{Space}
 z/ - {BackSpace}z{Space}
 x/ - {BackSpace}x{Space}
 c/ - {BackSpace}c{Space}
 v/ - {BackSpace}v{Space}
 b/ - {BackSpace}b{Space}
 n/ - {BackSpace}n{Space}
 m/ - {BackSpace}m{Space}
 est/ - {BackSpace}est{Space}
 ear/ - ear{Space}
 spot/ - spot{Space}
 st/ - {BackSpace}st{Space}
 later/ - latter{Space}
 ster/ - steer{Space}
 host/ - host{Space}
 per/ - peer{Space}
 aebl/ - {BackSpace}{BackSpace}able{Space}
 teas/ - tease{Space}
 law/ - law{Space}
 els/ - {BackSpace}less{Space}
 ear/ - ear{Space}
 sevr/ - sever{Space}
 ist/ - {BackSpace}ist{Space}
 eis/ - {BackSpace}ise{Space}
 cnsl/ - counsel{Space}
 purse/ - pursue{Space}
 won/ - won{Space}
 y/ - {backspace}y{Space}
 n/ - {backspace}n{Space}
adlbm - lambda{Space}
agb - bag{Space}
ahklc - chalk{Space}
asfkl - flask{Space}
asg - gas{Space}
dcvn - evidence{Space}
dfgl - fledgling{Space}
dlbn - blend{Space}
eashc - chase{Space}
eashm - shame{Space}
edlbn - blend{Space}
eialxcm - exclaim{Space}
eidcvn - evidence{Space}
eidh - hide{Space}
eidh - hide{Space}
eidxn - index{Space}
eipsc - spice{Space}
eisdl - slide{Space}
eisghln - english{Space}
eoacn - ocean{Space}
eoacn - ocean{Space}
eohkc - choke{Space}
eolvn - novel{Space}
eopaslc - collapse{Space}
eopm - poem{Space}
eopscm - compose{Space}
eoshv - shove{Space}
eovn - oven{Space}
epadn - append{Space}
epaln - plane{Space}
epaslm - sample{Space}
epl - peel{Space}
epshl - helps{Space}
erd - red{Space}
eriacm - america{Space}
eriagnm - migraine{Space}
erid - ride{Space}
eridcn - discern{Space}
eridn - dinner{Space}
erifgn - finger{Space}
eripz - prize{Space}
eriscn - sincere{Space}
erisdv - diverse{Space}
erohc - chore{Space}
erpsv - preserve{Space}
ersfh - fresh{Space}
ertab - batter{Space}
ertalc - accelerate{Space}
ertalc - accelerate{Space}
ertib - tribe{Space}
erticm - metric{Space}
erticn - eccentric{Space}
ertisn - insert{Space}
ertlacn - central{Space}
ertsc - secret{Space}
ertshc - stretch{Space}
ertuac - creature{Space}
ertugl - regulate{Space}
ertuocn - counter{Space}
ertyab - battery{Space}
erug - urge{Space}
eruisc - cruise{Space}
eruop - europe{Space}
erusm - summer{Space}
erypl - reply{Space}
esdk - desk{Space}
etadgvn - advantage{Space}
etag - gate{Space}
etahbn - beneath{Space}
etascn - stance{Space}
etdl - delete{Space}
etiacn - ancient{Space}
etiasgvn - investigate{Space}
etiashlb - establish{Space}
etib - bite{Space}
etick - ticket{Space}
etid - diet{Space}
etioasc - associate{Space}
etiopzmt - optimize{Space}
etiplnm - implement{Space}
etips - spite{Space}
etipsd - despite{Space}
etlvn - evolution{Space}
eto - toe{Space}
etocm - comet{Space}
etodhm - method{Space}
etpdh - depth{Space}
etpdh - depth{Space}
etshkc - sketch{Space}
etualc - calculate{Space}
etuin - unite{Space}
euagl - league{Space}
euosm - mouse{Space}
eupgln - plunge{Space}
eyidl - yield{Space}
eyoplm - employ{Space}
eyplm - employ{Space}
frst - forest{Space}
hvb - behave{Space}
iacbn - cabin{Space}
ial - {backspace}ial{Space}
ialcn - clinical{Space}
ialm - mail{Space}
ialn - nail{Space}
iasb - bias{Space}
iasflc - fascial{Space}
ilb - bill{Space}
ilcbm - climb{Space}
iogbn - bingo{Space}
iopsn - poison{Space}
iosdvn - division{Space}
ipafc - pacific{Space}
isa - asia{Space}
isdh - dish{Space}
isdh - dish{Space}
isdkn - kinds{Space}
lcnm - column{Space}
lxcm - exclaim{Space}
oafm - foam{Space}
osl - loss{Space}
pasn - span{Space}
pgln - plunge{Space}
phlnm - phenomenal{Space}
phnm - phenomenon{Space}
plcm - compile{Space}
plcnm - compliance{Space}
psc - species{Space}
pslc - collapse{Space}
radgn - grand{Space}
radk - dark{Space}
radk - dark{Space}
rahc - char{Space}
rdv - drive{Space}
rfgn - finger{Space}
rglabn - aboriginal{Space}
rgnm - migraine{Space}
riab - rabbi{Space}
riadf - afraid{Space}
rialcnm - criminal{Space}
rian - rain{Space}
rian - rain{Space}
ridg - grid{Space}
rifac - africa{Space}
rio - {backspace}ior{Space}
riofc - friction{Space}
riopsn - prison{Space}
riopsnm - imprison{Space}
ripg - grip{Space}
ripsgn - spring{Space}
ripsgn - spring{Space}
rlcnm - criminal{Space}
rlvb - variable vrbl{Space}
rlvb - variable{Space}
rlvbn - vulnerable{Space}
roagn - organ{Space}
rodm - dorm{Space}
rofg - frog{Space}
rofl - floor{Space}
ropf - proof{Space}
rpash - sharp{Space}
rpsgn - passenger{Space}
rpz - prize{Space}
rsdv - diverse{Space}
rtg - guitar{Space}
rtgcn - congregate{Space}
rtgl - regulate{Space}
rthlzn - horizontal{Space}
rtid - dirt{Space}
rtid - dirt{Space}
rtiob - orbit{Space}
rtiofcn - friction{Space}
rtiopm - import{Space}
rtiopm - import{Space}
rtipascn - transcript{Space}
rtips - strip{Space}
rtlcv - vertical{Space}
rtopal - portal{Space}
rtopas - pastor{Space}
rtpcn - counterpart{Space}
rtphcnm - anthropomorphic{Space}
rtsc - structure{Space}
rtsc - secret{Space}
rtscb - subtract{Space}
rtscn - countries{Space}
rtsda - asteroid{Space}
rtshc - stretch{Space}
rtuiga - guitar{Space}
rtuoc - court{Space}
rtyid - dirty{Space}
rtyid - dirty{Space}
rtyplxn - explanatory{Space}
rual - rural{Space}
ruhc - church{Space}
ryiaf - fairy{Space}
ryoacnm - acronym{Space}
rysdnm - syndrome{Space}
ryub - bury{Space}
ryuijn - injury{Space}
sdvn - division{Space}
sfm - famous{Space}
sghln - english{Space}
shlab - abolish{Space}
tadgvn - advantage{Space}
tafl - flat{Space}
tal - tall{Space}
taskl - stalk{Space}
tasv - vast{Space}
tdvn - divinity{Space}
tfcn - notification{Space}
tflcn - conflict{Space}
thbn - beneath{Space}
tiab - bait{Space}
tiagn - giant{Space}
tialcn - atlantic{Space}
tiasc - statistic{Space}
tiasln - install{Space}
tihcb - bitch{Space}
tikc - tick{Space}
tiod - idiot{Space}
tipaslc - plastic{Space}
tiscn - instance{Space}
toafl - float{Space}
tofn - font{Space}
tokc - tock{Space}
toskc - stock{Space}
tpad - adapt{Space}
tpasm - stamp{Space}
tplnm - implement{Space}
tpsd - despite{Space}
tpsgh - spaghetti{Space}
tpslc - plastic{Space}
tpslcb - susceptible{Space}
tsgvn - investigate{Space}
tshlb - establish{Space}
tslc - statistical{Space}
tuilb - built{Space}
tun - nut{Space}
tuohc - touch{Space}
tuosh - shout{Space}
tyipac - capacity{Space}
typlm - multiply{Space}
uion - union{Space}
uiosl - solution{Space}
ukcb - buck{Space}
uoasfm - famous{Space}
uodbn - bound{Space}
uohc - ouch{Space}
uosbn - bonus{Space}
upsl - plus{Space}
usdk - dusk{Space}
ush - hush{Space}
uskc - suck{Space}
wertin - winter{Space}
wetas - waste{Space}
wiph - whip{Space}
wran - warn{Space}
wrn - narrow{Space}
wro - row{Space}
wroa - arrow{Space}
wroan - narrow{Space}
wrobn - brown{Space}
wtuoal - outlaw{Space}
yaslvn - sylvan{Space}
ydl - yield{Space}
yisl - silly{Space}
ysk - sky{Space}
yup - yup{Space}
ealcn. - clean{Space}
eidv. - divide{Space}
eipsc. - species{Space}
erag. - rage{Space}
rg. - gear{Space}
erag/ - garage{Space}
eridn. - diner{Space}
erpsv. - persevere{Space}
rtlcn. - central{Space}
etal. - tale{Space}
etid. - tide{Space}
etiscn. - insect{Space}
euasc. - sauce{Space}
ial. - {BackSpace}{BackSpace}ial{Space}
od. - odd{Space}
osn. - son{Space}
rio. - {BackSpace}{BackSpace}ior{Space}
rohn. - horn{Space}
rsdcn. - discern{Space}
rtlvn. - revolution{Space}
rtuogh - thorough{Space}
tasc. - associate{Space}
tihn. - hint{Space}
tlsn. - solution{Space}
tpc. - capacity{Space}
typc - capacity{Space}
uohc. - couch{Space}
wdan. - dawn{Space}
wetas. - sweat{Space}
yil. - {BackSpace}{BackSpace}ily{Space}
ure/ - {BackSpace}{BackSpace}ure{Space}
